# KEY: (0=meadow, 1=forest, 2=water,3=wall, 4=bog, 5=swamp)
TERRAIN=
10122103214010112045
02025401000102120120
00002311401220414234
04003201002003103021
00220420502442001011
44200110020020000210
50402120121402141111
01005045310142034000
13210000020405014001
20302203110110015240
40201212010254225405
02010421220010043210
10001002201105221020
12011040041010413122
00111241100000102042
20000022203211023021
12013002110310400200
14122240011100132040
42011021111201011240
10102102230121213111

# KEY: (.=none, @=hero)
SPRITE=
....................
....................
....................
....................
....................
....................
...............*....
....................
....................
....................
....................
....................
....................
....................
....................
....................
....................
............@.......
....................
....................

# KEY: (0=not visible, 1=visible)
VISIBILITY=
00000000000000000000
00000000000000000000
00000000000000000000
00000000000000000000
00000000000000000000
00000000000000000000
00000000000000000000
00000000000000000000
00000000000000000000
00000000000000000000
00000000000000000000
00000000000000000000
00000000000000000000
00000000000000000000
00000000000000000000
00000000000000000000
00000000000010000000
00000000000111000000
00000000000010000000
00000000000000000000
