# KEY: (0=meadow, 1=forest, 2=water,3=wall, 4=bog, 5=swamp)
TERRAIN=
12400204131510440101
02140013032055010210
12440021024202201220
10021002401001210401
23020111021001211142
05111012211200141054
01124024014400004100
21001201001103232042
00031004210110010000
10102102001021021000
20121131402010001200
21010400011122100101
10040031402001223011
41113400212121020103
13002043310501202151
11105102055011150110
00210200011210410220
11101524505402001102
42012124421100100101
42001021050401144501

# KEY: (.=none, @=hero)
SPRITE=
....................
....................
....................
....................
....................
....................
....................
....................
....................
....................
....................
....................
................*...
....................
...@................
....................
....................
....................
....................
....................

# KEY: (0=not visible, 1=visible)
VISIBILITY=
00000000000000000000
00000000000000000000
00000000000000000000
00000000000000000000
00000000000000000000
00000000000000000000
00000000000000000000
00000000000000000000
00000000000000000000
00000000000000000000
00000000000000000000
00000000000000000000
00000000000000000000
00010000000000000000
00111000000000000000
00010000000000000000
00000000000000000000
00000000000000000000
00000000000000000000
00000000000000000000
